                                
                               
                                
                                
       ######         ########  
            #            #      
            #            #      
            #            #     
            #            #     
        #####################   
                 #              
                 #              
                 #        #     
                 #        #     
             #####        #     
        ######   ##########     
             #   #        #     
             $####        #     
                          #   
                               
